ALGORITHM		ae l g ao r ih dh m
ALI'S			ae l iy z
ANDENTEN		ae n d ax n t eh n
APP				ae p
B				b iy
BLAIR			b l ea
BLEE			b l iy
BREXIT			b r eh k s ih t
BRIE			b r iy
BRIN			b r ih n
C.O				s iy ow
CALON			c ey l oh n
CLAIRE			k l ea
COMPARASIVE		k ax m p ae r ax s ih v
CONNER			k oh n n ax
COULD'VE		k uh d ax v
CRAFTMAN		k r aa f t m ax n
D				d iy
DAR				d aa
DELF'VE			d eh l f v
DEV				d eh v
DISPLOIT		d ih s p l oy t
ENIT			iy n ih t
EVERYBOARD		eh v r iy b ao d
F				eh f
FEEDBLE			f iy d b l
FESS			f eh s
FRACENT			f r ey s ax n t
FROSTAN			f r oh s t ax n
GREE			g r iy
GUS				g ah s
H				ey ch
HOTTIE			oh t iy
INAUDIATE		h n ao d ih ey t
JAMIE			h ey m iy
LANCORN			ae n k ao n
LASE			l ey z
LOVE-AGE		ah v ih jh
MARB			m aa b
MUST'VE			ah s t v
NAV				n ae v
NEEP			n iy p
NIGE			n ay jh
O'LEARY			oh l ia r iy
ORIATION		ao r ia ey sh n
ORTHOMATIC		ao th oh m ae t ih k
PEVERALL		p ih v ax r a l
PRE				p r iy
PREAM			p r iy m
PRESCHOOL		p r iy s k uw l
RASLY			r aa z l iy
RATATOUILLE		r ae t ax t uw iy
RESELECTION		r eh s ih l eh k sh n
RISQUE			iy s k ey
ROM				r oh m
ROOMIE			r uw m i
S				eh s
SARGE			s er jh
SCALLION		s k ae l ia n
SHOULD'VE		sh uh d ax v
SMALLEM			s m ao l ax m
STATUTOR		s t ae ch uh t r
STIFROWN		s t ih f r aw n
THERE'LL		dh ea l
TIL				t ih l
UBIS			y ax b ih s
UNPERMITTED		ah n p ax m ih t ih d
WOULD'VE		w ax d ax v
YURT			y er t
ZITA			z iy t ax
